$ i  j  right left  up    down  prop
size 5 5
# 0  0  1     0     0     0     
# 0  1  1     1     0     0     
# 0  2  0     1     0     1     
# 1  0  1     0     0     0     
# 1  1  1     1     0     1     Dyl 
# 1  2  1     1     1     1     Tuu 
# 1  3  1     1     0     1     
# 1  4  0     1     0     1     
# 2  1  0     0     1     1     Tuu 
# 2  2  0     0     1     1     
# 2  3  1     0     1     1     Tud 
# 2  4  0     1     1     1     
# 3  0  1     0     0     0     Tr 
# 3  1  1     1     1     0     
# 3  2  1     1     1     1     
# 3  3  1     1     1     1     Dyl Dyu 
# 3  4  0     1     1     0     
# 4  0  1     0     0     0     
# 4  1  1     1     0     0     
# 4  2  1     1     1     0     Hi 
# 4  3  0     1     1     0     